Agree	Concordar [Concordo/Concordei, Concorda/Concordou, Concordamos, Concordam/Concordavam]
Aim	Mirar [Miro/Mirei, Mira/Mirou, Miramos, Miram/Miravam]
Allow	Permitir [Permito/Permiti, Permite/Permitiu, Permitimos, Permitem/Permitiram]
Answer	Responder [Respondo/Respondi, Responde/Respondeu, Respondemos, Respondem/Respondiam]
Arrive	Chegar [Chego/Cheguei, Chega/Chegou, Chegamos, Chegam/Chegavam]
Ask	Pedir [Peço/Pedi, Pede/Pediu, Pedimos, Pedem/Pediam]
Attack	Atacar [Ataco/Ataquei, Ataca/Atacou, Atacamos, Atacam/Atacavam]
Be (permanent)	Ser [Sou/Fui, É/Foi, Somos, São/Eram]
Be (temporary)	Estar [Estou/Estive, Está/Esteve, Estamos, Estão/Estavam]
Believe	Acreditar [Acredito/Acreditei, Acredita/Acreditou, Acreditamos, Acreditam/Acreditavam]
Block	Bloquear [Bloqueio/Bloqueei, Bloqueia/Bloqueou, Bloqueamos, Bloqueiam/Bloqueavam]
Bring	Trazer [Trago/Trouxe, Traz/Trouxe, Trazemos, Trazem/Traziam]
Care (about)	Se importar (com) [Me importo/Me importei, Se importa/Se importou, Nos importamos, Se importam/Se importavam]
Catch	Pegar [Pego/Peguei, Pega/Pegou, Pegamos, Pegam/Pegavam]
Change	Mudar [Mudo/Mudei, Muda/Mudou, Mudamos, Mudam/Mudavam]
Choose	Escolher [Escolho/Escolhi, Escolhe/Escolheu, Escolhemos, Escolhem/Escolhiam]
Come	Vir [Venho/Vim, Vem/Veio, Vimos, Vêm/Vinham]
Continue	Continuar [Continuo/Continuei, Continua/Continuou, Continuamos, Continuam/Continuavam]
Deal with	Lidar (com) [Lido/Lidei, Lida/Lidou, Lidamos, Lidam/Lidavam]
Decide	Decidir [Decido/Decidi, Decide/Decidiu, Decidimos, Decidem/Decidiam]
Defeat	Derrotar [Derroto/Derrotei, Derrota/Derrotou, Derrotamos, Derrotam/Derrotavam]
Defend	Defender [Defendo/Defendi, Defende/Defendeu, Defendemos, Defendem/Defendiam]
Despise	Desprezar [Desprezo/Desprezei, Despreza/Desprezou, Desprezamos, Desprezam/Desprezavam]
Die	Morrer [Morro/Morri, Morre/Morreu, Morremos, Morrem/Morriam]
Disagree	Discordar [Discordo/Discordei, Discorda/Discordou, Discordamos, Discordam/Discordavam]
Dislike	Desgostar [Desgosto/Desgostei, Desgosta/Desgostou, Desgostamos, Desgostam/Desgostavam]
Do / Make	Fazer [Faço/Fiz, Faz/Fez, Fazemos, Fazem/Faziam]
Drink	Beber [Bebo/Bebi, Bebe/Bebeu, Bebemos, Bebem/Bebiam]
Drop	Derrubar [Derrubo/Derrubei, Derruba/Derrubou, Derrubamos, Derrubam/Derrubavam]
Eat	Comer [Como/Comi, Come/Comeu, Comemos, Comem/Comiam]
Enter	Entrar [Entro/Entrei, Entra/Entrou, Entramos, Entram/Entravam]
Escape	Escapar [Escapo/Escapei, Escapa/Escapou, Escapamos, Escapam/Escapavam]
Exist	Existir [Existo/Existi, Existe/Existiu, Existimos, Existem/Existiam]
Experiment	Experimentar [Experimento/Experimentei, Experimenta/Experimentou, Experimentamos, Experimentam/Experimentavam]
Explain	Explicar [Explico/Expliquei, Explica/Explicou, Explicamos, Explicam/Explicavam]
Fail	Fracassar [Fracasso/Fracassei, Fracassa/Fracassou, Fracassamos, Fracassam/Fracassavam]
Fail to / Stop doing	Deixar de [Deixo de/Deixei de, Deixa de/Deixou de, Deixamos de, Deixam de/Deixavam de]
Fear	Temer [Temo/Temi, Teme/Temeu, Tememos, Temem/Temiam]
Fight	Lutar [Luto/Lutei, Luta/Lutou, Lutamos, Lutam/Lutavam]
Find	Achar [Acho/Achei, Acha/Achou, Achamos, Acham/Achavam]
Finish	Terminar [Termino/Terminei, Termina/Terminou, Terminamos, Terminam/Terminavam]
Fix	Consertar [Conserto/Consertei, Conserta/Consertou, Consertamos, Consertam/Consertavam]
Follow	Seguir [Sigo/Segui, Segue/Seguiu, Seguimos, Seguem/Seguiam]
Force	Forçar [Forço/Forcei, Força/Forçou, Forçamos, Forçam/Forçavam]
Forget	Esquecer [Esqueço/Esqueci, Esquece/Esqueceu, Esquecemos, Esquecem/Esqueciam]
Fuck	Foder [Fodo/Fodi, Fode/Fodeu, Fodemos, Fodem/Fodiam]
Get / Obtain	Conseguir [Consigo/Consegui, Consegue/Conseguiu, Conseguimos, Conseguem/Conseguiam]
Give	Dar [Dou/Dei, Dá/Deu, Damos, Dão/Davam]
Go	Ir [Vou/Fui, Vai/Foi, Vamos, Vão/Iam]
Guess / Imagine	Imaginar [Imagino/Imaginei, Imagina/Imaginou, Imaginamos, Imaginam/Imaginavam]
Hang out / Go out with	Sair com [Saio com/Saí com, Sai com/Saiu com, Saímos com, Saem com/Saíam com]
Hate	Odiar [Odeio/Odiei, Odeia/Odiou, Odiamos, Odeiam/Odiavam]
Have	Ter [Tenho/Tive, Tem/Teve, Temos, Têm/Tinham]
Have dinner	Jantar [Janto/Jantei, Janta/Jantou, Jantamos, Jantam/Jantavam]
Have lunch	Almoçar [Almoço/Almocei, Almoça/Almoçou, Almoçamos, Almoçam/Almoçavam]
Have sex (colloquial)	Transar [Transo/Transeei, Transa/Transou, Transamos, Transam/Transavam]
Hear / Listen to	Ouvir [Ouço/Ouvi, Ouve/Ouviu, Ouvimos, Ouvem/Ouviam]
Hit (object)	Acertar [Acerto/Acertei, Acerta/Acertou, Acertamos, Acertam/Acertavam]
Hope	Esperar [Espero/Esperei, Espera/Esperou, Esperamos, Esperam/Esperavam]
Hurt	Machucar [Machuco/Machuquei, Machuca/Machucou, Machucamos, Machucam/Machucavam]
Hypothesize	Hipotetizar [Hipotetizo/Hipotetizei, Hipotetiza/Hipotetizou, Hipotetizamos, Hipotetizam/Hipotetizavam]
Ignore	Ignorar [Ignoro/Ignorei, Ignora/Ignorou, Ignoramos, Ignoram/Ignoravam]
Improve	Melhorar [Melhoro/Melhorei, Melhora/Melhorou, Melhoramos, Melhoram/Melhoravam]
Keep	Manter [Mantenho/Mantive, Mantém/Manteve, Mantemos, Mantêm/Mantinham]
Kill	Matar [Mato/Matou, Mata/Matou, Matamos, Matam/Matavam]
Know (fact)	Saber [Sei/Soube, Sabe/Soube, Sabemos, Sabem/Sabiam]
Know (person/place)	Conhecer [Conheço/Conheci, Conhece/Conheceu, Conhecemos, Conhecem/Conheciam]
Learn	Aprender [Aprendo/Aprendi, Aprende/Aprendeu, Aprendemos, Aprendem/Aprendiam]
Leave (place)	Sair [Saio/Saí, Sai/Saiu, Saímos, Saem/Saíam]
Leave (something behind)	Deixar [Deixo/Deixei, Deixa/Deixou, Deixamos, Deixam/Deixavam]
Like	Gostar [Gosto/Gostei, Gosta/Gostou, Gostamos, Gostam/Gostavam]
Look (at)	Olhar [Olho/Olhei, Olha/Olhou, Olhamos, Olham/Olhavam]
Lose	Perder [Perco/Perdi, Perde/Perdeu, Perdemos, Perdem/Perdiam]
Love	Amar [Amo/Amei, Ama/Amou, Amamos, Amam/Amavam]
Meet	Encontrar [Encontro/Encontrei, Encontra/Encontrou, Encontramos, Encontram/Encontravam]
Miss (object)	Errar [Erro/Errei, Erra/Errou, Erramos, Erram/Erravam]
Miss (someone)	Sentir falta [Sinto falta/Senti falta, Sente falta/Sentiu falta, Sentimos falta, Sentem falta/Sentiam falta]
Monitor	Monitorar [Monitoro/Monitorei, Monitora/Monitorou, Monitoramos, Monitoram/Monitoravam]
Need	Precisar [Preciso/Precisei, Precisa/Precisou, Precisamos, Precisam/Precisavam]
Police	Policiar [Policio/Policiei, Policia/Policiou, Policiamos, Policiam/Policiavam]
Protect	Proteger [Protejo/Protegi, Protege/Protegeu, Protegemos, Protegem/Protegiam]
Put	Pôr [Ponho/Pus, Põe/Pôs, Pomos, Põem/Punham]
Relax	Relaxar [Relaxo/Relaxe, Relaxa/Relaxou, Relaxamos, Relaxam/Relaxavam]
Remember	Lembrar [Lembro/Lembrei, Lembra/Lembrou, Lembramos, Lembram/Lembravam]
Remove	Remover [Removo/Removi, Remove/Removeu, Removemos, Removem/Removiam]
Repair	Reparar [Reparo/Reparei, Repara/Reparou, Reparamos, Reparam/Reparavam]
Research	Pesquisar [Pesquiso/Pesquisei, Pesquisa/Pesquisou, Pesquisamos, Pesquisam/Pesquisavam]
Resist	Resistir [Resisto/Resisti, Resiste/Resistiu, Resistimos, Resistem/Resistiam]
Rest	Descansar [Descanso/Descansei, Descansa/Descansou, Descansamos, Descansam/Descansavam]
Return	Voltar [Volto/Voltei, Volta/Voltou, Voltamos, Voltam/Voltavam]
Rob	Assaltar [Assalto/Assaltei, Assalta/Assaltou, Assaltamos, Assaltam/Assaltavam]
Say / Tell	Dizer [Digo/Disse, Diz/Disse, Dizemos, Dizem/Diziam]
Score	Marcar [Marco/Marquei, Marca/Marcou, Marcamos, Marcam/Marcavam]
See	Ver [Vejo/Vi, Vê/Viu, Vemos, Veem/Viam]
Seem	Parecer [Pareço/Pareci, Parece/Pareceu, Parecemos, Parecem/Pareciam]
Shoot (firearm)	Atirar [Atiro/Atirei, Atira/Atirou, Atiramos, Atiram/Atiravam]
Sleep	Dormir [Durmo/Dormi, Dorme/Dormiu, Dormimos, Dormem/Dormiam]
Smoke	Fumar [Fumo/Fumei, Fuma/Fumou, Fumamos, Fumam/Fumavam]
Snack	Lanchar [Lancho/Lanchei, Lancha/Lanchou, Lanchamos, Lancham/Lanchavam]
Speak	Falar [Falo/Falei, Fala/Falou, Falamos, Falam/Falavam]
Start	Começar [Começo/Comecei, Começa/Começou, Começamos, Começam/Começavam]
Start to / Begin to	Passar a [Passo a/Passei a, Passa a/Passou a, Passamos a, Passam a/Passavam a]
Stay / Become	Ficar [Fico/Fiquei, Fica/Ficou, Ficamos, Ficam/Ficavam]
Steal	Roubar [Roubo/Roubei, Rouba/Roubou, Roubamos, Roubam/Roubavam]
Stop	Parar [Paro/Parei, Para/Parou, Paramos, Param/Paravam]
Succeed	Conseguir [Consigo/Consegui, Consegue/Conseguiu, Conseguimos, Conseguem/Conseguiam]
Suppose	Supor [Suponho/Supus, Supõe/Supôs, Supomos, Supõem/Supunham]
Survive	Sobreviver [Sobrevivo/Sobrevivi, Sobrevive/Sobreviveu, Sobrevivemos, Sobrevivem/Sobreviviam]
Take / Carry	Levar [Levo/Levei, Leva/Levou, Levamos, Levam/Levavam]
Teach	Ensinar [Ensino/Ensinei, Ensina/Ensinou, Ensinamos, Ensinam/Ensinavam]
Test	Testar [Testo/Testei, Testa/Testou, Testamos, Testam/Testavam]
Think	Pensar [Penso/Pensei, Pensa/Pensou, Pensamos, Pensam/Pensavam]
Threaten	Ameaçar [Ameaço/Ameacei, Ameaça/Ameaçou, Ameaçamos, Ameaçam/Ameaçavam]
Throw	Arremessar [Arremesso/Arremessei, Arremessa/Arremessou, Arremessamos, Arremessam/Arremessavam]
Try	Tentar [Tento/Tentei, Tenta/Tentou, Tentamos, Tentam/Tentavam]
Turn / Become	Virar [Viro/Virei, Vira/Virou, Viramos, Viram/Viravam]
Understand	Entender [Entendo/Entendi, Entende/Entendeu, Entendemos, Entendem/Entendiam]
Use	Usar [Uso/Usei, Usa/Usou, Usamos, Usam/Usavam]
Wait (for)	Esperar [Espero/Esperei, Espera/Esperou, Esperamos, Esperam/Esperavam]
Want	Querer [Quero/Quis, Quer/Quis, Queremos, Querem/Queriam]
Watch	Assistir [Assisto/Assisti, Assiste/Assistiu, Assistimos, Assistem/Assistiam]
Whisper	Sussurrar [Sussurro/Sussurrei, Sussurra/Sussurrou, Sussurramos, Sussurram/Sussurravam]
Win	Ganhar [Ganho/Ganhei, Ganha/Ganhou, Ganhamos, Ganham/Ganhavam]
Work	Trabalhar [Trabalho/Trabalhei, Trabalha/Trabalhou, Trabalhamos, Trabalham/Trabalhavam]
Worsen	Piorar [Pioro/Piorei, Piora/Piorou, Pioramos, Pioram/Pioravam]
Yell	Gritar [Grito/Gritei, Grita/Gritou, Gritamos, Gritam/Gritavam]
